F,183,1,0
F,184,1,0
F,185,1,0
F,186,1,0
F,187,1,0
F,188,1,0
F,189,1,0
F,190,1,0
F,191,1,0
F,192,1,0
F,193,1,4
F,194,1,0
F,195,1,0
F,196,1,0
F,197,1,0
F,198,1,0
P,1,1,24797
K,0,1,24797