F,190,1,0
F,191,1,1
F,192,1,4
F,193,1,1
F,194,1,3
F,195,2,0
P,1,1,24797
K,0,1,24797